15.ox
oo........o........o.o.......o
.....o.ooo....oo.........o..o.
o..ooo..o....oooo......o.o.o..
....o.....ooo......o.oo..o...o
o..o.o....o.o...o..o..o..ooo..
........o...oo.o..oo.oo.......
.o.ooo...o.o.o..o.o......o..o.
.o..o...o.......o.......o...o.
.....o..o.o.o.o......ooooo..o.
oooo...o..o..o.o.o........o.oo
.o..............oo..o...o....o
...o.o.o.o.oo....o............
....ooo.oo..o..ooo...oo.......
...o.o..o.o..o.o...o...o...oo.
o....oo.o..o...o......oooo.oo.
