9@-Z
-@@-@@--@@-@@-@@@@@-
@@@@--@@--@@-@@-@-@@
@@@@@-@@-@@--@-@@-@@
@---@@@@@-@@@-@--@@@
@-@@@@@@-@@-@@@@-@@-
@@@@@@@@@-@@@-@@-@@@
@@@@@@@@@-@@@@@@@@@-
@@@-@-@@--@@@@@@@@@@
@-@--@@@@@-@@--@-@@@
