9.ox
...........o...o.oo.
.oo..ooo.ooo..o..o..
o.....o....oo.o...oo
.oo...o..o.....oo...
...o....o.......oo..
.......o..o......o..
o..o.........o.o..o.
...o.............oo.
o.........ooooo...oo
