9.ox
ooo...o....o.o.o...o
........o..o..o...oo
.oo...o....oo.o.oo..
.....oo......o..o...
.o.o...oo....o...oo.
..oo....o...o.....o.
.o..o.o.o.o......o..
....o..o.o...oo..o.o
.......o..o..oo.oo..
