9.ox
o.........o....ooooo
o..o..o.o..o...o..oo
oo.oo......o.o..ooo.
..o..o....o....o....
o.o..o..oo.....oo...
o...o....o.........o
oo....o...oo.o..o...
........o.....o.o..o
..o.....o..o......o.
