15.ox
.........o..o..o......o..o...o
.....o.........oooo.o....oo...
....o...ooo.ooo....o.........o
.oo...o..oooo....o...o........
..o..o....oo.o...o.oo.o...o.o.
o....oo.o..o.o.......o.o.....o
o.o.o..o.o...oo...o.oo.......o
........ooo...o.o.oo......o..o
..o..ooo..o.......o..oo.oo..oo
..oo..oo.....o...o.....oo.o..o
.....oo....o.........oo.oo....
oo...oo..o....ooo....o..o...oo
....oo....o.o.o........o......
o...oo..o...o.o........oooo.oo
.o...oo.........o......o.o.o.o
