15.ox
................o.o.oooo...oo.
.o.oo.....o..o...oo.ooo.....o.
.oo...oo.....oo.oo..o..o..oo..
....o..oo....o..o.o......o.o..
o.o...o...o...o..o..o..oooo...
...o.o.o.o....o...o...o.....o.
o..o.o....o....oo..o.o..o.oooo
..oo...o.oo.o.........ooo..ooo
o.......o.oo..o.o.o...o..o....
oo.....o.....o.o.oo...........
..o..o........oo..........o...
.......o....o.ooo.oo...ooo.o..
.ooo...o.oo.oo.o...o.oo.oo.ooo
o..........o......o.o...oo..o.
o......oooo.....oo...o..o.o.o.
