15.ox
...o.o...o.o...oo....oo.......
...o....o......o.o.o...o.o...o
.....ooo...o..o.o.o.oo....oo.o
..............oo.o.o.ooo..o.oo
o....o.o............ooo.....o.
...o..oo.....o.....o.o..oo.oo.
..o......oo.......o.o....o...o
......o.......o.oo.....o..o.o.
.o...o.oo..o.oo...o..oo.o...o.
.o.oo.o.o....o...o.......oo...
.o..ooo....oo...........o..o..
....o........ooo.......oo.....
..o.....o.o.oooooo......oo.o.o
....o..oo.oo.o...........oo...
o................o.o..o.o..oo.
