9@-Z
-o@-@@--@@-@@-@@@@@-
@@@kf@--@@--@@-@@-@-
@@@@@t-@@-@@--@-@@-@
@---@@o@@-@@@-@--@@@
@-@@@@@@-@@-@@@@-@@-
@@@@@@@@@-@@@-@@-@@@
@@@@@@@@@-@@@@@@@@@-
@@@-@-@@--@@@@@@@@@@
@-@--@@@@@-@@--@-@@@
